; Labirinto de exemplo
9 14 10
##############
#S..a...A....#
#..##..$..#..#
#..T...##....#
#...b..B...#.#
#.......E....#
#..#...#.....#
#...#.e#...s.#
##############